111111111111111111111111111111
1P1000100000000000000000000001
101010101111111111111111111011
101010101000000000000000000001
101010101011111111111111111011
101010101010100000000000000001
101010101010101111111111111011
10000000000000000000000000C011
101010101010100C00000000000011
101010101010100C00000000000011
101010101010100C00000000000011
101010101010100C00000000000011
101010101010100C00000000000011
1E1010101010100C00000000000011
111111111111111111111111111111